1111111111
1000010011
1111011011
1111011011
1111000011
1111111111