11111111111
10100010101
10101010101
10101010101
10101010101
10101010101
10101010101
10101010101
10001000101
11111110001