111111111
1000001K1
111110101
100010101
101000101
101111101
10000L0L1
111111111