111111111
1000001K1
111110101
1000101K1
1010001K1
101111101
10000L0L1
111111111