111111111
100011101
111011101
100010101
101000101
101111101
10000L0L1
111111011