111111111
1000111K1
111011101
1000111K1
1010001K1
101111101
10000L0L1
111111011